R 1920 1080
NO ./textures/stone.xpm
SO ./textures/wood.xpm
WE ./textures/mossy.xpm
EA ./textures/redbrick.xpm

S ./textures/coronavirus.xpm
F 57, 105, 188 
C 66, 151, 51 

		1111111111111111111111111111111111111
		1000000000110000000000000000000000001
		1011000001110000002000000000000000001
		1001000000000000000000000000000000001
111111111011000001110000000002000000000000001
100000000011000001110111111111111111111110011
11110111111111011100000000001			1001
1111011111111101110000000W001			1001
11000020000001011100000000001			1001
10000000000001000000000000001111111111111001
10000000000000000000000000000000000000000001
11000001110101011111011100001111111111111001
10000111 1000101 101111010001			1001
11111111 1111111 111111111111			1111