R 8000 8000

NO ./textures/stone.xpm
SO ./textures/wood.xpm
WE ./textures/mossy.xpm
EA ./textures/redbrick.xpm

S ./textures/coronavirus.xpm

F 220,100,0
C 225,30,0

11111111
10000001
10000001
100W0001
11111111
